-16
18
-7
7
00000000000000000000000000000000000
11111111111111111111111111111111110
00000000000000000000000000000000000
00000000000000000000000000000000000
00000000000000000000000011111110000
00000000000000010000000011111110000
00000000100000000000000011111110000
00000000000000000000000011111110000
00000000000000000000000011111110000
00000000000010000000000011111110000
00000000000000000000000011111110000
00000000000000000000000000000000000
00000000000000000000000000000000000
00000000000000000000000000000000000
00000000000000000000000000000000000
